1111111111
100C000101
1P00000001
100E000101
1111111111
