1111111111
100C000101
1P00000101
100E000101
1111111111
