11111111111111111111111111
100C00C011000C0011C0000111
10000000000C0001110C000001
100001111000C000101C001101
1P001001C00C11101C00011111
1000C000C000C11C000C01C001
10001010E0100C0001C1000001
11111111111111111111111111