1111111111111111
100C000C10010001
10C01100C0110011
101000110C000101
1001001000C10011
11P00100C0100E01
1111111111111111