1111111111
100C000101
1P0001C001
101E1001C1
1111111111