1111111111
100C000101
100001P001
101C1001E1
1111111111