1111111
10PC0E1
1000001
1010001
1111111