11111111111111111111111111111
10C010C010C010C010C010C010C01
10101010101010101010101010101
10101010101010101010101010101
10101010101010101010101010101
10101010101010101010101010101
10101010101010101010101010101
10101010101010101010101010101
10101010101010101010101010101
10101010101010101010101010101
10101010101010101010101010101
10101010101010101010101010101
10101010101010101010101010101
10101010101010101010101010101
1P10C010C010C010C010C010C01E1
11111111111111111111111111111