11111111111111111111111111111111111111111111111
10000000000000000000000000000000000000000000001
100C00C011000C0011C0000100C0011C001C00000010011
10000000000C0001110C00000100000000C0001110C0001
100001111000C000101C00110100000000C0001110C0001
1P001001C00C11101C0001111100000000C00110C000001
1000C000C000C11C001C01C00100000000C0001110C0001
10001010E0100C0001C000000100000000C00011C000001
11111111111111111111111111111111111111111111111