1111111111
100C000101
100001C001
10101001C1
101C100101
101C000101
1C1C010101
1P1C1011E1
1111111111