11111111111111
10000C0000C001
1C000000000011
100000C0000011
1000E000000011
1000P000000011
100000C0000011
10101000C00011
11111111111111