1111111
10T00T1
1TTTTT1
1TTTTT1
1000001
1PE1C01
1111111