111111
1PC001
1001C1
100001
1T00T1
100E01
111111