111111
1PC001
1001C1
100011
1T01T1
100E01
111111