1111111111111111111111111
1001100100011001100110011
100T00100T00100T00100C001
100C00000C100C00C00010011
1011C0011101T000000100011
1P00C00T01001000T001C00E1
1111111111111111111111111